t u v t u v t u v t u v t u v t u v t u v t u v t u v t u v t
u v t u v t u v t u v t u v t u v t u v t u v t u v t u v t u
v t u v t u v t u v t u v t u v t u v t u v t u v t u v t u v
t u v t u v t u v t u v t u v t u v t u v t u v t u v t u v t
u v t u v t u v t u v t u v t u v t u v t u v t u v t u v t u
v t u v t u v t u v t u v t u v t u v t u v t u v t u v t u v
t u v t u v t u v t u v t u v t u v t u v t u v t u v t u v t
u v t u v t u v t u v t u v t u v t u v t u v t u v t u v t u
v t u v t u v t u v t u v t u v t u v t u v t u v t u v t u v
t u v t u v t u v t u v t u v t u v t u v t u v t u v t u v t
u v t u v t u v t u v t u v t u v t u v t u v t u v t u v t u
v t u v t u v t u v t u v t u v t u v t u v t u v t u v t u v
t u v t u v t u v t u v t u v t u v t u v t u v t u v t u v t
u v t u v t u v t u v t u v t u v t u v t u v t u v t u v t u
v t u v t u v t u v t u v t u v t u v t u v t u v t u v t u v
t u v t u v t u v t u v t u v t u v t u v t u v t u v t u v t
u v t u v t u v t u v t u v t u v t u v t u v t u v t u v t u
v t u v t u v t u v t u v t u v t u v t u v t u v t u v t u v
t u v t u v t u v t u v t u v t u v t u v t u v t u v t u v t
u v t u v t u v t u v t u v t u v t u v t u v t u v t u v t u
v t u v t u v t u v t u v t u v t u v t u v t u v t u v t u v
t u v t u v t u v t u v t u v t u v t u v t u v t u v t u v t
u v t u v t u v t u v t u v t u v t u v t u v t u v t u v t u
v t u v t u v t u v t u v t u v t u v t u v t u v t u v t u v
t u v t u v t u v t u v t u v t u v t u v t u v t u v t u v t
u v t u v t u v t u v t u v t u v t u v t u v t u v t u v t u
v t u v t u v t u v t u v t u v t u v t u v t u v t u v t u v
t u v t u v t u v t u v t u v t u v t u v t u v t u v t u v t
u v t u v t u v t u v t u v t u v t u v t u v t u v t u v t u
v t u v t u v t u v t u v t u v t u v t u v t u v t u v t u v
t u v t u v t u v t u v t u v t u v t u v t u v t u v t u v t